NO ./images/dali3.png
SO ./images/dali4.png
WE ./images/irises.png
EA ./images/pony.png

F 18,53,25
C 153,204,255

111111111111
1         11
1111111 1101
100000010011
10S000000001
111111111111
11         1
111111111111
