NO ./images/dali3.png
SO ./images/dali4.png
WE ./images/irises.png
EA ./images/

F 20,20,20
C 200,200,200

11111
10001
10S01
11111
