NO ./path_to_the_north_texture
SO ./path_to_the_south_texture
WE ./path_to_the_west_texture
EA ./path_to_the_east_texture

F 220,100,0
C 225,30,0


11111111111111111111111111111111111
10000000001100000000000000000000001
10110000011100000000000000000000001
10010000000000000000000000000000001
11111111101100000111000000000000001
10000000001100000111011111111111001
11110111111111011100000010000000001
11110111111111011101010010000000001
11000000110101011100000010000000001
10000000000000000000000010000000001
10000000000000000001010010000000001
11000001010101011111011010N00011001
11110111011101010101111010000000001
11111111111111111111111111111111111