11111111111111111111111111111111111
10000000001100000000000000000000001
10110000011100000000000000000000001
10010000000000000000000000000000001
11111111101100000111000000000000001
10000000001100000111011111111111001
11110111111111011100000010000000001
11110111111111011101010010000000001
11000000110101011100000010000000001
10000000000000001100000010000000001
10000000000000001101010010000000001
11000001010101011111011010N00011001
11110111011101010101111010000000001
11111111111111111111111111111111111