NO ./images/north.png
SO ./images/south.png
WE ./images/west.png
EA ./images/east.png

F 139,69,19
C 135,206,235


11111111111111111111111111111111111
10000000000000000000000000000000001
10000000000000000000000000000000001
100000000000000W0000000000000000001
10000000000000000000000000000000001
10000000000000000000000000000000001
10000000000000000000000000000000001
10000000000000000000000000000000001
10000000000000000000000000000000001
10000000000000000000000000000000001
10000000000000000000000000000000001
11111111111111111111111111111111111
