111111111111111111111111111111111
100000000011000000000000000000001
101100000111000000000000000000001
100100000000000000000000000000001
  111111111011000001110000000000001
  100000000011000001110111111111001
  111101111111110111000010000000001
  111101111111110111010010000000001
110000001101010100000010000000001
100000000000000000000010000000001
100000000000000001010010000000001
110000010101011111011010N00011001
111101111101010101111010000000001
111111111111111111111111111111111