NO ./images/dalivangogh.png
SO ./images/dali4.png
WE ./images/starrynight.png
EA ./images/rooftops.png

F 139,69,19
C 135,206,235


		1111111111111111111111111
        1000000000110000000000001
        1011000001110000000000001
        1001000000000000000000001
111111111011000001110000000000001
100000000011000001110111110111111
11110111111111011100000010001
11110111111111011101010000001
11111000110101011100000010001
    10000000000011000000100011
111110000000000001101010010001
11000001110101011111011110N001
11110111 1110101 1011110100011
11111111 1111111 111111011111