NO ./images/dali3.png
SO ./images/dali4.png
WE ./images/irises.png
EA ./images/pony.png

F 139,69,19
C 135,206,235

1111111111111111111111111
1000000000110000000000001
1011000001110000000000001
1001000000000000000000001
1000000011000001110111110111111
11110111	1110101	10111101001
11000001110101011111011110E0111
1111111111111111111111111111111